1111111111111
10C0000101E11
1000011000011
1P00000000001
1111111111111
