1111111111111111111111111111111111
1E0000000000000C00000C000011111001
1010010100111111101001000C00010101
10100P0010101010001001000000011111
111100000C00C000000000000000001111
1111111111111111111111111111111111
