1111111111111
10C0000101E11
1011011C01011
1P000000000C1
1111111111111