1111111111111111111111111111111111
1E00000000R0000C00000C000000000001
1010010100100000101001000R00010101
101R0P0010101010001001000000010101
100000000C00C00000R00000R0000000C1
1111111111111111111111111111111111