11111111111111111111111
1CCCC0000CCC0110CCCC001
110000000CCCCCCC000C001
1101110000111100C00C001
1E0000CC00111100000P001
11111111000111000000001
10CCCCCC000010CCCCCCC01
10C0000000001100000C001
11011100CC111100000C001
10000000CCCC0000000C001
11111111111111111111111