11111111111111
11C00000000011
10000101R0C001
1R0PRC000001E1
11111111111111