111111111111111
1R0C00000000011
101000101R0C001
100PRC000001E11
111111111111111